0 0 0 0 0 0 0 0 0 0 0 0 0 0 0 0 0 0 0 0 0 0 0 0 0 0 0 0 0 0 0 0 0 0 0 0 0 0 0 0 0 0 0 0 0 0 0 0 0 0 
0 0 0 0 0 0 0 0 0 0 0 0 0 0 0 0 0 0 0 0 0 0 0 0 0 0 0 0 0 0 0 0 0 0 0 0 0 0 0 0 0 0 0 0 0 0 0 0 0 0 
0 0 0 0 0 0 0 0 0 0 0 0 0 0 0 0 0 0 0 0 0 0 0 0 0 0 0 0 0 0 0 0 0 0 0 0 0 0 0 0 0 0 0 0 0 0 0 0 0 0 
0 0 0 0 0 0 0 0 0 0 0 0 0 0 0 0 0 0 0 0 0 0 0 0 0 0 0 0 0 0 0 0 0 0 0 0 0 0 0 0 0 0 0 0 0 0 0 0 0 0 
0 0 0 0 0 0 0 0 0 0 0 0 0 0 0 0 0 0 0 0 0 0 0 0 0 0 0 0 0 0 0 0 0 0 0 0 0 0 0 0 0 0 0 0 0 0 0 0 0 0 
0 0 0 0 0 0 0 0 0 0 0 0 0 0 0 0 0 0 0 0 0 0 0 0 0 0 0 0 0 0 0 0 0 0 0 0 0 0 0 0 0 0 0 0 0 0 0 0 0 0 
0 0 0 0 0 0 0 32 32 32 32 32 32 32 32 32 32 32 32 32 32 32 32 32 32 32 32 32 32 32 32 32 32 32 32 32 32 32 32 32 32 32 32 0 0 0 0 0 0 0 
0 0 0 0 0 0 0 32 36 3 32 32 32 32 32 32 32 32 32 32 32 32 32 32 32 32 32 32 32 32 32 32 32 32 32 32 32 32 32 32 32 32 32 0 0 0 0 0 0 0 
0 0 0 0 0 0 0 32 3 3 32 32 32 32 32 3 3 3 3 3 3 32 32 32 32 32 32 32 32 32 32 3 3 3 3 3 3 32 32 32 32 32 32 0 0 0 0 0 0 0 
0 0 0 0 0 0 0 32 32 3 32 32 32 32 3 3 3 3 3 3 3 3 32 32 32 32 32 32 32 32 3 3 3 3 32 32 3 32 32 32 32 32 32 0 0 0 0 0 0 0 
0 0 0 0 0 0 0 32 32 3 3 3 3 3 3 3 3 3 3 3 3 3 32 32 32 32 3 3 3 3 3 3 3 32 32 3 3 3 3 3 3 32 32 0 0 0 0 0 0 0 
0 0 0 0 0 0 0 32 32 32 32 32 32 32 3 3 3 3 3 3 3 3 32 32 32 3 3 3 3 3 3 3 32 3 32 32 3 3 3 32 32 32 32 0 0 0 0 0 0 0 
0 0 0 0 0 0 0 32 32 32 32 32 32 32 32 3 3 3 3 3 3 32 32 32 3 3 3 3 3 3 3 3 3 32 32 32 3 3 3 32 32 32 32 0 0 0 0 0 0 0 
0 0 0 0 0 0 0 32 32 32 32 32 32 32 32 32 32 3 3 32 32 32 32 3 3 3 3 3 3 32 32 32 32 32 3 3 3 3 3 3 32 32 32 0 0 0 0 0 0 0 
0 0 0 0 0 0 0 32 32 32 32 32 32 32 32 32 32 3 3 32 32 32 3 3 3 32 32 32 32 32 32 32 32 3 3 3 3 3 3 3 32 32 32 0 0 0 0 0 0 0 
0 0 0 0 0 0 0 32 32 32 32 32 32 32 32 3 3 3 3 3 32 32 3 3 3 32 32 3 32 32 32 32 32 32 32 3 3 3 3 3 3 32 32 0 0 0 0 0 0 0 
0 0 0 0 0 0 0 32 32 32 32 32 32 3 3 3 32 3 3 3 32 32 3 32 32 32 32 3 32 32 32 32 32 32 3 3 3 3 3 3 3 32 32 0 0 0 0 0 0 0 
0 0 0 0 0 0 0 32 3 3 32 32 32 32 32 32 32 3 3 32 32 3 3 32 32 3 3 3 3 3 32 32 3 3 3 3 3 3 3 3 32 32 32 0 0 0 0 0 0 0 
0 0 0 0 0 0 0 32 3 3 3 3 3 3 32 32 32 32 3 3 32 32 32 3 32 32 3 3 3 3 3 32 3 3 32 3 3 32 32 3 32 32 32 32 0 0 0 0 0 0 0 
0 0 0 0 0 0 0 32 3 3 3 3 3 32 32 32 32 32 3 3 32 32 3 3 32 3 3 3 3 3 3 3 32 32 32 3 32 32 3 32 32 32 32 0 0 0 0 0 0 0 
0 0 0 0 0 0 0 32 3 3 3 3 3 32 32 32 32 32 3 32 32 32 3 32 32 32 3 3 3 3 32 32 32 32 3 32 32 32 3 32 32 32 32 0 0 0 0 0 0 0 
0 0 0 0 0 0 0 32 3 3 3 3 3 32 32 32 32 32 3 32 32 32 3 3 32 32 32 32 32 32 32 32 32 3 32 32 32 32 3 32 32 32 32 0 0 0 0 0 0 0 
0 0 0 0 0 0 0 32 32 32 3 32 32 32 32 32 32 3 3 3 3 3 3 3 32 32 32 32 32 32 32 32 32 3 32 32 32 32 3 32 32 32 32 0 0 0 0 0 0 0 
0 0 0 0 0 0 0 32 32 32 3 32 32 32 32 32 32 3 3 3 32 32 32 32 32 32 32 32 32 32 32 32 3 32 32 32 32 3 3 3 3 32 32 0 0 0 0 0 0 0 
0 0 0 0 0 0 0 32 32 32 3 32 32 32 3 3 3 3 3 3 3 3 32 32 32 32 32 32 32 32 32 32 32 32 3 3 3 3 3 3 3 32 32 0 0 0 0 0 0 0 
0 0 0 0 0 0 0 32 32 32 3 32 32 3 3 3 3 3 3 3 3 3 3 32 32 32 32 32 32 32 32 32 3 3 3 3 3 3 3 3 3 32 32 0 0 0 0 0 0 0 
0 0 0 0 0 0 0 32 32 32 3 3 3 3 3 3 3 3 3 3 3 3 3 32 32 32 32 32 32 32 32 32 3 3 3 3 3 3 3 3 3 32 32 0 0 0 0 0 0 0 
0 0 0 0 0 0 0 32 32 32 3 3 3 3 3 3 3 3 3 3 3 3 3 32 32 32 32 32 32 32 32 32 3 3 3 3 3 3 3 3 3 32 32 0 0 0 0 0 0 0 
0 0 0 0 0 0 0 32 32 32 32 32 32 32 3 3 3 3 3 3 3 3 3 3 3 3 3 3 3 3 3 3 3 3 3 3 3 32 32 3 3 32 32 0 0 0 0 0 0 0 
0 0 0 0 0 0 0 32 32 32 32 32 32 32 32 32 32 3 3 32 32 32 32 32 32 32 3 32 32 32 32 32 3 3 3 32 32 32 32 3 3 32 32 0 0 0 0 0 0 0 
0 0 0 0 0 0 0 32 32 32 32 32 32 32 32 32 32 3 3 32 32 32 32 32 32 32 3 32 32 32 32 32 32 32 32 32 32 32 3 3 3 32 32 0 0 0 0 0 0 0 
0 0 0 0 0 0 0 32 32 32 32 32 32 32 32 32 32 3 3 32 32 32 32 32 32 32 3 32 32 32 32 32 32 32 32 32 32 32 32 3 3 32 32 0 0 0 0 0 0 0 
0 0 0 0 0 0 0 32 32 32 32 32 32 32 32 32 32 3 3 32 32 32 32 32 32 32 3 32 32 32 32 32 32 32 32 32 32 32 32 32 32 32 32 0 0 0 0 0 0 0 
0 0 0 0 0 0 0 32 32 32 32 32 32 32 32 32 32 3 3 32 32 32 32 32 32 3 3 3 32 32 32 32 32 32 32 32 32 32 32 32 32 32 32 0 0 0 0 0 0 0 
0 0 0 0 0 0 0 32 32 32 32 32 32 32 32 32 32 3 3 32 32 32 32 32 32 3 3 3 32 32 32 32 32 32 32 32 32 32 32 32 32 32 32 0 0 0 0 0 0 0 
0 0 0 0 0 0 0 32 32 32 32 32 32 32 32 3 3 3 3 3 3 32 32 32 32 32 32 32 32 32 32 32 32 32 32 32 32 32 32 32 32 32 32 0 0 0 0 0 0 0 
0 0 0 0 0 0 0 32 32 32 32 32 32 32 32 3 3 3 3 3 3 32 32 32 32 32 32 32 32 32 32 32 32 32 32 32 32 32 32 32 32 32 32 0 0 0 0 0 0 0 
0 0 0 0 0 0 0 32 32 3 3 3 3 3 3 3 3 3 3 3 3 32 32 32 32 32 32 32 32 32 32 32 32 32 32 32 3 3 3 3 3 32 32 0 0 0 0 0 0 0 
0 0 0 0 0 0 0 32 32 3 32 32 32 32 32 3 3 3 3 3 3 32 32 32 32 32 32 32 32 32 32 32 3 3 3 3 3 3 32 32 3 32 32 0 0 0 0 0 0 0 
0 0 0 0 0 0 0 32 32 3 32 32 32 32 32 3 3 3 3 3 3 32 32 32 32 32 32 32 32 32 32 3 3 3 3 3 3 32 32 32 3 32 32 0 0 0 0 0 0 0 
0 0 0 0 0 0 0 32 3 3 3 32 32 32 32 3 3 3 3 3 3 3 3 3 3 3 3 3 3 3 3 3 3 3 3 3 3 32 32 32 3 32 32 0 0 0 0 0 0 0 
0 0 0 0 0 0 0 32 3 37 3 32 32 32 32 32 32 32 32 32 32 32 32 32 32 32 32 32 32 32 32 32 3 3 3 3 3 32 32 32 3 32 32 0 0 0 0 0 0 0 
0 0 0 0 0 0 0 32 3 3 3 32 32 32 32 32 32 32 32 32 32 32 32 32 32 32 32 32 32 32 32 32 32 32 32 32 32 32 32 32 32 32 32 0 0 0 0 0 0 0 
0 0 0 0 0 0 0 32 32 32 32 32 32 32 32 32 32 32 32 32 32 32 32 32 32 32 32 32 32 32 32 32 32 32 32 32 32 32 32 32 32 32 32 0 0 0 0 0 0 0 
0 0 0 0 0 0 0 0 0 0 0 0 0 0 0 0 0 0 0 0 0 0 0 0 0 0 0 0 0 0 0 0 0 0 0 0 0 0 0 0 0 0 0 0 0 0 0 0 0 0 
0 0 0 0 0 0 0 0 0 0 0 0 0 0 0 0 0 0 0 0 0 0 0 0 0 0 0 0 0 0 0 0 0 0 0 0 0 0 0 0 0 0 0 0 0 0 0 0 0 0 
0 0 0 0 0 0 0 0 0 0 0 0 0 0 0 0 0 0 0 0 0 0 0 0 0 0 0 0 0 0 0 0 0 0 0 0 0 0 0 0 0 0 0 0 0 0 0 0 0 0 
0 0 0 0 0 0 0 0 0 0 0 0 0 0 0 0 0 0 0 0 0 0 0 0 0 0 0 0 0 0 0 0 0 0 0 0 0 0 0 0 0 0 0 0 0 0 0 0 0 0 
0 0 0 0 0 0 0 0 0 0 0 0 0 0 0 0 0 0 0 0 0 0 0 0 0 0 0 0 0 0 0 0 0 0 0 0 0 0 0 0 0 0 0 0 0 0 0 0 0 0 
0 0 0 0 0 0 0 0 0 0 0 0 0 0 0 0 0 0 0 0 0 0 0 0 0 0 0 0 0 0 0 0 0 0 0 0 0 0 0 0 0 0 0 0 0 0 0 0 0 0 
